NO ../tests/cub3D/wall/exit.xpm
SO ../tests/cub3D/wall/chest.xpm
WE ../tests/cub3D/wall/slime.xpm
EA ../tests/cub3D/wall/wall.xpm

C 125,       230, 50
F 124,23,14

1111
1W01
1001
1E01
1111