NO ../tests/cub3D/wall/exit.xpm
SO ../tests/cub3D/wall/chest.xpm
WE ../tests/cub3D/wall/slime.xpm
EA ../tests/cub3D/wall/wall.xpm

C 125,       230,4
F 124,23,14

111111111111111
110010000000001
101000000000001
100000110000001
100000000000001
100000000000001
10000N000000001
100000000000001
111111111111111