11111111111111111
10C100000C100C1C1
10110111111011101
10100000001000101
1000111P001110101
1C100E10000000001
11111111111111111
