1111111111111111111111111111111111
110000000000000C00000C000000000001
1E10010100100000110001000000010101
1011111111111111000111111111111111
1P0000000C00C0000100000000000000C1
1111111111111111111111111111111111
