1111111111
1P10000001
10C0111C01
10101E0101
1010110101
1010000101
10111C1101
10C0000001
1111111111
