1111111111111
1001000000P01
1000011111001
100011E000001
1111111111111
