1111111111
1P10000001
1010111101
10101E0101
1010110101
1010110101
1010000101
1011111101
10C0000001
1111111111
