NO assets/textures/slime.xpm
SO assets/textures/chest.xpm
WE assets/textures/slime.xpm
EA assets/textures/wall.xpm

C 125,       230,4
F 124,23,14

1111
1001
1001
1E01
1111